Уровень 2
0 0 0 0 0 0 0 0 0 0 
0 0 0 0 0 0 0 0 0 0 
0 0 0 0 0 0 0 0 0 0 
0 0 0 1 1 1 0 0 0 0 
0 0 0 Ф 1 Б 0 0 0 0 
0 0 0 Ф 1 1 1 1 0 0 
0 0 0 0 Б 1 0 1 0 0 
0 0 0 0 1 1 1 1 0 0 
0 0 0 0 0 0 0 0 0 0 
0 0 0 0 0 0 0 0 0 0 
5 5