Уровень 1
0 0 0 0 0 0 0 0 0 0 
0 0 0 0 0 0 0 0 0 0 
0 0 0 0 Ф Ф Ф 0 0 0 
0 0 0 0 0 Б 1 0 0 0 
0 0 0 0 0 1 1 0 0 0 
0 0 0 0 1 Б Б 1 0 0 
0 0 0 0 1 1 1 0 0 0 
0 0 0 0 1 1 0 0 0 0 
0 0 0 0 0 0 0 0 0 0 
0 0 0 0 0 0 0 0 0 0 
5 4 